xxx1111x11
1x1111x111
11x0000000
x1000000xx
x100000011
1100000011
1x000000x1
11x0000011
111x000011
111100x111
