1111111111
1111111111
1110000000
1100000011
1100000011
1100000011
1100000011
1110000111
1111000111
1111001111
