1111111111
1111111111
1110000111
1100000011
1100000011
1100000011
1100000011
1110000111
1111011111
1111011111
