111000111111111
111001100001111
111000000000111
111100000000011
100000000000011
100000000000001
110111000001101
110111000001101
110011000001101
111011000001101
110011010101101
110011111111100
110111111111111
110000000001111
111000000000000
111111111111111
