1110001111111111
111000000000000x
1110011111111111
111000011x111111
1110000001xx1x11
11110000000xx111
100000000000x1x1
1000000000000111
1000000000000001
1101110000011101
1101110000011101
1100110000011100
11001100000x1111
1100111010x11111
1100111111111111
1101111111111111
1100000000000000
11100000000xxxxx
11x1111111x1111x
1x1xx111xx1x111x
x1111xxx11x1xxx1
