111110001111111111
11111000000000000x
111110011111111111
11111000011x111111
1111x0000001xx1x11
1111110000000xx111
11100000000000x1x1
111000000000000111
11x000000000000001
111x01110000011101
111101110000011101
111100110000011100
1111001100000x1111
111100111010x11111
111100111111111111
111101111111111111
111x00000000000000
1111x00000000xxxxx
1111x1111111x1111x
111x1xx111xx1x111x
11x1111xxx11x1xxx1
