xxxxx000xxx...
111xxx0000xx..
11111xx0000x..
......x00000x.
......xx0000x.
......x10000xx
......x1x0000x
1.....xx11000x
1111111111100x
1110011111110x
1100000011100x
000000000b1111
x01x11h111xxxx
x11011h1101111
x10000000001x1
x1000000000x1x
1x010010000x1x
x00001110001x1
x0001xx1x000bx
1xxxx11x1xxxx1
