1111111111
0011111100
1000011001
1100000011
1111000011
1111111111
1000000001
1000000001
1000000001
1111111111
