111111111111111
111111111111111
111101111111111
111000111111111
100000001111111
100010000001111
101111000001111
111111100000111
111111100000111
111111x00000111
111111100010111
111111x00100111
111111100000111
111111x000000h1
1111111x0000111
......11x000111
......111000011
......111x000x1
......1111x00xx
......11111000x
