x11111111x
1111111111
x111000000
x101111111
x111b11111
11x000x111
111x0x1111
111xhx1111
111x01x111
x11111111x
