x11111111x
1111111111
1100001111
1110011111
1111b0111x
110000011x
11100x1111
111xb0111x
1110bx1111
x111b1111x
