00000000000000000b0000000000000000x
x000000000000000000000000000000000x
x000000000000000000000000000000000x
x000000000000000010000000000000000x
x000000000000000hh1000000000000000x
x0000011111000011x110000b000000000x
x0000h1000000000111000000000000000x
x000000000000000010000000000000000x
x00q000b00000000000000000000000000x
1111111111111xxxxxx1111111111111111
1111111111111x1111xx111111111111111
xxxxxxxxxxxxxx11111xxxxxxxxxxxxxxxx
11111111111111111111111111111111111
11111111111111111111111111111111111
11111111111111111111111111111111111
11111111111111111111111111111111111
11111111111111111111111111111111111
11111111111111111111111111111111111
11111111111111111111111111111111111
11111111111111111111111111111111111
