0000000000000000000000000000000000x
x000000000000000000000000000000000x
x000000000000000000000000000000000x
x000000000000000010000000000000000x
x000000000000000111000000000000000x
x000001111100001111100000000000000x
x000011000000000111000000000000000x
x000000000000000010000000000000000x
x000000000000000000000000000000000x
1111111111111xxxxxx1111111111111111
1111111111111x1111xx111111111111111
xxxxxxxxxxxxxx11111xxxxxxxxxxxxxxxx
11111111111111111111111111111111111
11111111111111111111111111111111111
11111111111111111111111111111111111
11111111111111111111111111111111111
11111111111111111111111111111111111
11111111111111111111111111111111111
11111111111111111111111111111111111
11111111111111111111111111111111111
