xxxxxxxxxxxxxxxxxxxxxxxxxxxxxxxxxxxxxxxx
000000000000000000000000000000000000111x
xq0000000000000000000000000000000000111x
x00000000000000000000000000000000000111x
x00000000000000000000000000000000000111x
x00000000000000000000000000000000000111n
111111111111111100000111111111111111111x
x11111111111111100000111111111111111111x
x11111111111110000000000011111111111111x
x11111111110000000100000000000001111111x
x11000000000000001b10000000000000111111x
x0000000000011111111110000000000000000xx
x000000001111111111111111111000000000bxx
x1111111111111111111111111111111111111xx
x11111111111111111111111111111111111111x
xxxxxxxxxxxxxxxxxxxxxxxxxxxxxxxxxxxxxxxx
