xxxxxxxxqxxxxxxxxxxxxxxxxxxxxxx
x111111100xxxxxx1x11111111xxxxx
x11111110000xxxxxxx1111111110xx
x11111110000000b11111111110000x
xx0111110000000111110000000000x
x11111111111111100000000000000x
x00000000000000000000000000000x
x00000000000000000000000000000x
x0000000000000000000000b0000000
x11111111111111110000011111111x
x111111111h1111110000011111111x
x00000000001111110000011111111x
x00000000001111110000011111111x
x0000000000011111101011111111xx
x0000001111111111111111111111xx
x00000011111111111111111111111x
x00000000000111111111111111111x
x00000000000111111111111111111x
x00000000000110000000000000000n
x11111111111111111111111111111x
x11111111111111111111111111111x
xxxxxxxxxxxxxxxxxxxxxxxxxxxxxxx
