xxxxxxxxxxxx
n1100000001x
x111100000x1
x111110000hx
x111110q01x1
xx11111101x1
xxx11111011x
xxxxxxxxnxxx
