1n1111111111111111111
10000000000b111111111
1q0000000001111111111
100000000011111111111
100000000111110011111
111111111100000000001
100000000000000000bb1
1000000000000000000b1
10010000000000000000n
111111111111000001111
100000001111000001111
100000011111000001111
100000111111101011111
111100001111111111111
100000000111111111111
100000000111111111111
100001111111111111111
10000000000000000000n
111111111111111111111
