100010000100000000000000000
000000000000000000000000000
000000000000000000000000000
000000000000000000000000000
000010000000000110000000000
001000000000000000011100000
000001100000000000000111000
000000100000000000000000000
011111100000000000000000000
111111111100011000011111111
