xxxxxxxxxxxxxxxxxxxxxxxxxxxxxxxxxxxx
x1111111111111111111111111111111111x
x1111111111111111111111111111111111x
x1111111111111111111111111111111111x
x1111111111111111111111111111111111x
x1111111111111111111111111111111111x
x1111111111111111111111111111111111x
x1111111111111111111111111111111111x
x1111111100000000000000000011111111x
x11111111qb000000000000000011111111x
x1111111111000000000000000011111111x
x1111111100000000000000000011111111x
x111111110b000000000000000011111111x
x1111111111000000000000000011111111x
x1111111100000000000000000011111111x
x111111110b000000000000000011111111x
x1111111111000000000000000011111111x
x1111111100000000000000000011111111x
x111111110b000000000000000011111111x
x1111111111000000000000000011111111x
x1111111100000000000000000011111111x
x1111111100000000000000000011111111x
x1111111111000000000000000011111111x
x1111111100000000000000000011111111x
x111111110b000000000000000011111111x
x1111111111000000000000000011111111x
x1111111100000000000000000011111111x
x111111110bbbbbbbbbbbbbbbb011111111x
x1111111111bbbbbbbbbbbbbbb011111111x
x1111111100bbbbbbbbbbbbbbb011111111x
x1111111100bbbbbbbbbbbbbbb011111111x
x1111111111111111111111111111011111x
x1111111111111111111111111110001111x
x1111111111111111111111111100000111x
x1111111111111111111111111000000011x
x1111111111111111111111110000000001x
x1111111111111111111111111000000011x
x1111111111111111111111111100000111x
x1111111111111111111111111110001111x
x1111111111111111111111111111111111x
xxxxxxxxxxxxxxxxxxxxxxxxxxxxxxxxxxxx
