00000000100000000000000000
01000000000000000000000000
00000000000000000000000000
00000000000000000000000000
11100011110000111100000111
