00000000000000000b0000000000000000x
x000000000000000000000000000000000x
x000000000000000000000000000000000x
x000000000000000010000000000000000x
x000000000000000hh1000000000000000x
x0000011111000011x110000b000000000x
xx000h1000000000111000000000000000x
xx00000000000000010000000000000000x
xxxq000b00000000000000000000000000x
11xxx11111111xxxxxx1111111111111111
n111111111111x1111xx111111111111111
xxxxxxxxxxxxxx11111xxxxxxxxxxxxxxxx
11111111111111111111111111111111111
11111111111111111111111111111111111
11111111111111111111111111111111111
11111111111111111111111111111111111
11111111111111111111111111111111111
11111111111111111111111111111111111
11111111111111111111111111111111111
11111111111111111111111111111111111
