................
......11111.....
......10001.....
111111100111.....
1000000011001...
10000001100011..
11110000000111..
...00001111111..
...00011........
...00011........
...10011........
