xxxxxxxxxxxxxxxxxxxxxxxxxxxxxxxxxxxxxxxxxxxxxxxxxx
xxx0000000000000000000000000000000000000000xxxxxxx
xx00000000000000000000000000000000000000000000xxxx
x0000000000000000111111110000000000000000000000xxx
x000000000000011xxxx111111000000000000000000000xxx
x0000000000001111111111111000000000000000000000xxx
x00000000000000000011111000000000000000000000000xx
x00000011110000000000000000000000000000000000000xx
x000h0011110000000000000000000000000000000000000xx
nq000b000000000000000000000000000000000000000000xx
x111111111000000111111111111110000000000000000000n
x11111111111111111111111111111111111111111111111xx
x1111111111111111111111111111111111111111111111111
x1111111111111111111111111111111111111111111111111
x11111111111111111111111111111111111111111111111xx
x111111111111111111111111111111111111111111111111x
xxxxx11111111111xxxxxxxxxx111111111111xxxxx11111x1
1111xxxxxxxxxxxxx11111111xxxxxxxxxxxxxx111xxxxxxx1
