xxxxxxxxxxxxxxnx
x00000000011x10x
x00000000011x10x
n0q00000000b011x
x1101x11h1111x1x
x1111011h11101xx
x1110000000001xx
x1110000000001xx
x1110100100001xx
x1100001110001xx
x110001111100bxx
x1111111111111xx
xxxxxxxxxxxxxxxx
